{
  "name": "Village",
  "map": [
    ["1-6:0-0", "1-6:1-0", "1-6:2-0", "1-6:3-0", "1-6:1-0", "1-6:2-0", "1-6:3-0", "1-6:1-0", "1-6:2-0", "1-6:3-0", "1-6:1-0", "1-6:2-0", "1-6:3-0", "1-6:1-0", "1-6:2-0", "1-6:3-0", "1-6:1-0", "1-6:2-0", "1-6:3-0", "1-6:4-0"],
    ["1-7:0-0", "g", "g", "g", "g", "g", "g", "g", "g", "g", "g", "g", "g", "g", "g", "g", "g", "g", "g", "1-7:4-0"],
    ["1-7:0-0", "p", "p", "p", "p", "p", "p", "p", "p", "p", "p", "p", "p", "p", "b", "b", "g", "g", "g", "1-7:4-0"],
    ["1-7:0-0", "g", "p", "g", "g", "g", "g", "g", "g", "g", "g", "g", "g", "g", "b", "b", "g", "g", "g", "1-7:4-0"],
    ["1-7:0-0", "g", "p", "g", "g", "g", "g", "g", "g", "g", "g", "g", "g", "g", "g", "g", "g", "g", "g", "1-7:4-0"],
    ["1-7:0-0", "g", "p", "g", "g", "g", "g", "g", "g", "g", "g", "g", "g", "g", "g", "g", "g", "g", "g", "1-7:4-0"],
    ["1-7:0-0", "g", "p", "g", "g", "g", "g", "g", "g", "g", "g", "g", "g", "g", "g", "g", "g", "g", "g", "1-7:4-0"],
    ["1-7:0-0", "g", "p", "g", "g", "g", "g", "g", "g", "g", "g", "g", "g", "g", "g", "g", "g", "g", "g", "1-7:4-0"],
    ["1-7:0-0", "g", "p", "g", "g", "g", "g", "g", "g", "g", "g", "g", "g", "g", "g", "g", "g", "g", "g", "1-7:4-0"],
    ["1-7:0-0", "g", "p", "g", "g", "g", "g", "g", "g", "a", "a", "a", "g", "g", "g", "g", "g", "g", "g", "1-7:4-0"],
    ["1-7:0-0", "g", "p", "g", "g", "g", "g", "g", "a", "a", "a", "g", "g", "g", "g", "g", "g", "g", "g", "1-7:4-0"],
    ["1-7:0-0", "g", "p", "g", "g", "g", "g", "g", "g", "a", "g", "g", "g", "g", "g", "g", "g", "g", "g", "1-7:4-0"],
    ["1-7:0-0", "g", "p", "g", "g", "g", "g", "g", "g", "a", "a", "g", "g", "g", "g", "g", "g", "g", "g", "1-7:4-0"],
    ["1-7:0-0", "g", "p", "p", "p", "p", "p", "p", "p", "p", "b", "b", "b", "g", "g", "g", "g", "g", "g", "1-7:4-0"],
    ["1-7:0-0", "g", "p", "g", "g", "g", "g", "g", "g", "g", "b", "b", "b", "g", "g", "g", "g", "g", "g", "1-7:4-0"],
    ["1-7:0-0", "g", "p", "g", "g", "g", "g", "g", "g", "g", "g", "g", "g", "g", "g", "g", "g", "g", "g", "1-7:4-0"],
    ["1-7:0-0", "g", "p", "g", "g", "g", "g", "g", "g", "g", "g", "g", "g", "g", "g", "g", "g", "g", "g", "1-7:4-0"],
    ["1-7:0-0", "g", "p", "g", "g", "g", "g", "g", "g", "g", "g", "g", "g", "g", "g", "g", "g", "g", "g", "1-7:4-0"],
    ["1-7:0-0", "g", "p", "g", "g", "g", "g", "g", "g", "g", "g", "g", "g", "g", "g", "g", "g", "g", "g", "1-7:4-0"],
    ["1-8:0-0", "1-8:1-0", "1-8:2-0", "1-8:3-0", "1-8:1-0", "1-8:1-0", "1-8:2-0", "1-8:3-0", "1-8:1-0", "1-8:1-0", "1-8:2-0", "1-8:3-0", "1-8:1-0", "1-8:1-0", "1-8:2-0", "1-8:3-0", "1-8:1-0", "1-8:1-0", "1-8:2-0", "1-8:4-0"]
  ],
  "texturePath": "1",
  "textures": ["basic", "bricks", "house-1", "walls"],
  "tileSize": 16,
  "resolutionCoefficient": 4,
  "hero": {
    "x": 0,
    "y": 2
  },
  "enemy": {
    "x": 1,
    "y": 1
  }
}