{
  "name": "Test Map",
  "map": [
    ["w", "w", "w", "w", "w", "w", "w", "w", "w", "w", "w", "w", "w", "w", "w", "w", "w", "w", "w", "w"],
    ["w", "g", "g", "g", "g", "g", "g", "g", "g", "g", "g", "g", "g", "g", "g", "g", "g", "g", "g", "w"],
    ["p", "p", "p", "p", "p", "p", "p", "p", "p", "p", "p", "p", "p", "p", "b", "b", "g", "g", "g", "w"],
    ["w", "g", "p", "g", "g", "g", "g", "g", "g", "g", "g", "g", "g", "g", "b", "b", "g", "g", "g", "w"],
    ["w", "g", "p", "g", "g", "g", "g", "g", "g", "g", "g", "g", "g", "g", "g", "g", "g", "g", "g", "w"],
    ["w", "g", "p", "g", "g", "g", "g", "g", "g", "g", "g", "g", "g", "g", "g", "g", "g", "g", "g", "w"],
    ["w", "g", "p", "g", "g", "g", "g", "g", "g", "g", "g", "g", "g", "g", "g", "g", "g", "g", "g", "w"],
    ["w", "g", "p", "g", "g", "g", "g", "g", "g", "g", "g", "g", "g", "g", "g", "g", "g", "g", "g", "w"],
    ["w", "g", "p", "g", "g", "g", "g", "g", "g", "g", "g", "g", "g", "g", "g", "g", "g", "g", "g", "w"],
    ["w", "g", "p", "g", "g", "g", "g", "g", "g", "a", "a", "a", "g", "g", "g", "g", "g", "g", "g", "w"],
    ["w", "g", "p", "g", "g", "g", "g", "g", "a", "a", "a", "g", "g", "g", "g", "g", "g", "g", "g", "w"],
    ["w", "g", "p", "g", "g", "g", "g", "g", "g", "a", "g", "g", "g", "g", "g", "g", "g", "g", "g", "w"],
    ["w", "g", "p", "g", "g", "g", "g", "g", "g", "a", "a", "g", "g", "g", "g", "g", "g", "g", "g", "w"],
    ["w", "g", "p", "p", "p", "p", "p", "p", "p", "p", "b", "b", "b", "g", "g", "g", "g", "g", "g", "w"],
    ["w", "g", "p", "g", "g", "g", "g", "g", "g", "g", "b", "b", "b", "g", "g", "g", "g", "g", "g", "w"],
    ["w", "g", "p", "g", "g", "g", "g", "g", "g", "g", "g", "g", "g", "g", "g", "g", "g", "g", "g", "w"],
    ["w", "g", "p", "g", "g", "g", "g", "g", "g", "g", "g", "g", "g", "g", "g", "g", "g", "g", "g", "w"],
    ["w", "g", "p", "g", "g", "g", "g", "g", "g", "g", "g", "g", "g", "g", "g", "g", "g", "g", "g", "w"],
    ["w", "g", "p", "g", "g", "g", "g", "g", "g", "g", "g", "g", "g", "g", "g", "g", "g", "g", "g", "w"],
    ["w", "w", "p", "w", "w", "w", "w", "w", "w", "w", "w", "w", "w", "w", "w", "w", "w", "w", "w", "w"]
  ],
  "hero": {
    "x": 0,
    "y": 2
  },
  "enemy": {
    "x": 1,
    "y": 1
  }
}